########
#......#
=..@...#
#......#
######.#
#.#....#
+.*$$..#
#.#....#
########
